


         NO   ./animals.xpm

             F  103, 103, 103

      SO   ./trees.xpm

           
           WE   ./sky.xpm
           EA    ./flowers.xpm


    C 20    ,     20,20











            1111111111111
            1N11
            1111111111111