


SO   ./trees.xpm

   NO   ./flowers.xpm
           
           WE   ./flowers.xpm
           EA    ./flowers.xpm


             F  200,200,200

C  0,0,0



  111111111111111
  110000001101011
  1000000N0000001
  111111111111111


