SO   ./sky.xpm

NO ./animals.xpm
            
           WE   ./sky.xpm
           EA  ./flowers.xpm

             F  163, 163, 163

    C 0,1,0

                1
                1  11111
                1111   1
                       1     
              111      1     
              1  1      1     
              1 11111111     
              1              
              1              
        1111111111111111111111111
        1000000000110000000000001
        1011000001110000000000001
      111111111111111111111111111        1
       1111111111111111111111111        101
        1001000000000000000000001        1  
111111111011000001110000000000001
100000000011000001111111111111111
111101111111110111 
11110111111111011 111111111111
110000001101010111 100000010001
100000000S0000001  100000010001
10000000000000001 101010010001
11000001110101011 11101111000111
11110111 1110101  101111010001
11111111 1111111  111111111111
