NO    ./path_to_the_north_texture.xpm
SO ./path_to_the_south_texture.xpm

										       
		F 220,100,0   

WE ./path_to_the_west_texture.xpm
EA ./path_to_the_east_texture.xpm
 
C 225,9,30


          1        
1   0
   111111
1001 01 
10   1001          
       1100N    1
  111111            
  000
  1


