NO    ./path_to_the_north_texture.xpm
SO ./path_to_the_south_texture.xpm

										       
		F 220,100,0   

WE ./path_to_the_west_texture.xpm
EA ./path_to_the_east_texture.xpm
 
C 225,9,30


          1  
1   0
   111111
1001 01 
101111001111111     
 1    111001N11   1
  1111111111111      
  10001
  1111


