NO    ./path_to_the_north_texture.xpm
SO ./path_to_the_south_texture.xpm

										       
		F 220,100,0   

WE ./path_to_the_west_texture.xpm
EA ./path_to_the_east_texture.xpm
 
C 225,9,30


1111111111111111
11101 1111111 
11101 1111111
11111 111S1111   
1111111111111
   100001
111111111111

