NO ./sky.xpm
SO ./animals.xpm  
WE ./trees.xpm
EA ./flowers.xpm

C 176,194,221					   
F 113,141,70

111111
100001
10E001
101001
111111
