NO ./sky.xpm
SO ./animals.xpm  
WE ./trees.xpm
EA ./flowers.xpm

C 176,194,221					       
F 113,141,70

111111111111111
100000111110001
10010000000S011
10000000001011
100000111100001
100000000011111
11111111111
