NO    ./path_to_the_north_texture.xpm
SO ./path_to_the_south_texture.xpm

										       
		F 113,141,70   

WE ./path_to_the_west_texture.xpm
EA ./path_to_the_east_texture.xpm
 
C 176,194,221


11111111111
10000000001
10000000001
100000E0001
11111111111
