SO   ./flowers.xpm

   NO   ./flowers.xpm
           
           WE   ./flowers.xpm
           EA    ./flowers.xpm

             F  163, 163, 163

    C 0,0,0




111111111
111000001111
1000N00000111
1110011111
111111111111