NO    ./sky.xpm
SO ./animals.xpm

										       
		F 113,141,70   

WE ./trees.xpm
EA ./flowers.xpm
 
C 176,194,221


11111111111
10W00000001
10000000001
10000000001
10000000001
11111111111
