NO    ./path_to_the_north_texture.xpm
SO ./path_to_the_south_texture.xpm

										       
		F 220,100,0   

WE ./path_to_the_west_texture.xpm
EA ./path_to_the_east_texture.xpm
 
C 225,9,30

111111
100101
101001
1100N1 
111111
