NO    ./path_to_the_north_texture.xpm
SO ./path_to_the_south_texture.xpm

										       
		F 113,141,70   

WE ./path_to_the_west_texture.xpm
EA ./path_to_the_east_texture.xpm
 
C 176,194,221


1111111111111111
11101 1111111 
11101 1111111
11111 111S1111   
1110010011111111
11111111111
1
