


SO   ./textures/xpm/wall.xpm

   NO   ./textures/xpm/wall.xpm
           
           WE   ./textures/xpm/wall.xpm
           EA    ./textures/xpm/wall.xpm

             F  133, 124, 65

    C 0,0,0












        1111111111111111111111111
        1000000000110000000000001
        1D111000001110000000000001
        1001000000000000000000111
1111111101100001110000000000001
10000000001100000111011D111111111
1111011111  1100011100000010001
11110111111111000D010100100011
  11000000110100011100000110001
  1000000100000001100000ND0001
  1000000000000001101010010001
  1100000111010101111101111000111
  11110111 1110101 101111010001
  11111111 11111111111111111111