


SO   ./textures/xpm/wall.xpm

   NO   ./textures/xpm/wall.xpm
           
           
           WE   ./textures/xpm/wall.xpm
           EA    ./textures/xpm/wall.xpm


             F  0,0,0

C  0,0,0













11111111111111111
  110000001101011
  1000000N0000001
  111111111111111


