SO   ./sky.xpm

   NO   ./animals.xpm
           
           WE   ./flowers.xpm
           EA    ./sky.xpm

             F  163, 163, 163

    C 0,0,0

111111111
101000001
101000001
100000001
1000N0001
111111111