


SO   ./animals.xpm

   NO   ./flowers.xpm
           
           WE   ./sky.xpm
           EA    ./trees.xpm

             F  163, 163, 163

    C 0,0,0


11111111111
10010000001
10010000001
10000000001
10N00000001
11111111111